#,#,#,#,#,#,#,#,.,.,.,.,#,#,#,#,#,#,#,#
#,.,.,.,.,.,.,.,.,.,.,.,.,.,.,.,.,.,.,#
#,.,.,.,.,.,.,.,.,.,.,.,.,.,.,.,.,.,.,#
#,.,.,.,.,.,.,.,.,.,.,.,.,.,.,.,.,.,.,#
#,.,.,.,.,.,.,.,.,.,.,.,.,.,.,.,.,.,.,#
#,.,.,.,.,.,.,.,.,.,.,.,.,.,.,.,.,.,.,#
#,.,.,.,.,.,.,.,.,.,.,.,.,.,.,.,.,.,.,#
#,~,~,~,.,.,.,.,.,.,.,.,.,.,.,~,~,~,~,#
#,~,~,~,~,.,.,.,.,.,.,.,.,.,~,~,~,~,~,#
#,~,~,~,~,~,.,.,.,.,.,.,.,~,~,~,~,~,~,#
#,#,#,#,#,#,#,#,#,#,#,#,#,#,#,#,#,#,#,#
