#,#,#,#,#,#,#,#,#,#,#,#,#,#,#,#,#,#,#,#
#,.,.,.,#,.,.,.,.,.,#,.,.,.,.,.,#,.,.,#
#,.,.,.,#,.,.,#,.,.,#,.,.,#,.,.,#,.,.,#
#,.,.,.,#,.,.,#,.,.,#,.,.,#,.,.,#,.,.,#
#,.,.,.,#,.,.,#,.,.,#,.,.,#,.,.,#,.,.,.
#,.,.,.,#,.,.,#,.,.,#,.,.,#,.,.,#,.,.,.
#,.,.,.,#,.,.,#,.,.,#,.,.,#,.,.,#,.,.,.
#,.,.,.,#,.,.,#,.,.,#,.,.,#,.,.,#,.,.,#
#,.,.,.,#,.,.,#,.,.,#,.,.,#,.,.,#,.,.,#
#,.,.,.,.,.,.,#,.,.,.,.,.,#,.,.,.,.,.,#
#,#,#,#,#,#,#,#,#,#,#,#,#,#,#,#,#,#,#,#
