#,#,#,#,#,#,#,#,#,.,.,.,#,#,#,#,#,#,#,#
#,.,.,.,.,.,.,#,.,.,.,.,.,#,.,.,.,.,.,#
#,.,.,.,#,.,.,#,.,.,.,.,.,#,.,.,#,.,.,#
#,.,.,.,#,.,.,#,.,.,.,.,.,#,.,.,#,.,.,#
.,.,.,.,#,.,.,#,.,.,.,.,.,#,.,.,#,.,.,.
.,.,.,.,#,.,.,#,.,.,.,.,.,#,.,.,#,.,.,.
.,.,.,.,#,.,.,#,.,.,.,.,.,#,.,.,#,.,.,.
#,.,.,.,#,.,.,#,.,.,.,.,.,#,.,.,#,.,.,#
#,.,.,.,#,.,.,#,.,.,.,.,.,#,.,.,#,.,.,#
#,.,.,.,#,.,.,.,.,.,.,.,.,.,.,.,#,.,.,#
#,#,#,#,#,#,#,#,#,#,#,#,#,#,#,#,#,#,#,#
