#,#,#,#,#,#,#,#,#,#,#,#,#,#,#,#,#,#,#,#
#,.,.,.,.,.,.,#,.,.,.,.,.,#,.,.,.,.,.,#
#,.,.,.,#,.,.,#,.,.,#,.,.,#,.,.,#,.,.,#
#,.,.,.,#,.,.,#,.,.,#,.,.,#,.,.,#,.,.,#
.,.,.,.,#,.,.,#,.,.,#,.,.,#,.,.,#,.,.,.
.,.,.,.,#,.,.,#,.,.,#,.,.,#,.,.,#,.,.,.
.,.,.,.,#,.,.,#,.,.,#,.,.,#,.,.,#,.,.,.
#,.,.,.,#,.,.,#,.,.,#,.,.,#,.,.,#,.,.,#
#,.,.,.,#,.,.,#,.,.,#,.,.,#,.,.,#,.,.,#
#,.,.,.,#,.,.,.,.,.,#,.,.,.,.,.,#,.,.,#
#,#,#,#,#,#,#,#,#,#,#,#,#,#,#,#,#,#,#,#
