R,R,R,R,R,R,R,R,R,R,R,R,R,R,R,R,R,R,R,R
R,.,.,.,.,.,.,.,.,.,.,.,.,.,.,.,.,.,.,R
R,.,.,.,G,G,G,.,.,.,.,.,.,T,T,.,.,.,.,R
R,.,.,G,G,G,.,.,.,.,.,.,.,T,.,.,.,.,.,R
R,.,.,.,.,.,.,.,.,.,.,.,.,.,.,.,.,.,.,.
R,.,.,.,.,.,.,.,.,R,R,.,.,.,.,.,.,.,.,.
R,.,.,.,.,.,.,.,.,.,.,.,.,.,.,.,.,.,.,.
R,.,.,.,.,G,G,.,.,.,.,.,.,.,.,R,.,.,.,R
R,.,.,R,.,G,.,.,.,.,.,.,.,.,.,R,.,.,.,R
R,.,.,.,.,.,.,.,.,.,.,.,.,.,.,.,.,.,.,R
R,R,R,R,R,R,R,R,R,R,R,R,R,R,R,R,R,R,R,R
