R,R,R,R,R,R,R,R,R,R,R,R,R,R,R,R,R,R,R,R
R,.,.,.,.,.,.,.,.,.,.,.,.,.,.,.,.,.,.,R
R,.,.,.,R,R,R,.,.,T,T,.,.,.,R,R,R,.,.,R
R,.,.,.,R,.,.,.,.,G,G,.,.,.,.,.,R,.,.,R
.,.,.,.,.,.,.,.,.,.,.,.,.,.,.,.,.,.,.,R
.,.,.,.,.,.,.,.,.,.,.,.,.,.,.,.,.,.,.,R
.,.,.,.,.,.,.,.,.,.,.,.,.,.,.,.,.,.,.,R
R,.,.,.,R,.,.,.,.,G,G,.,.,.,.,.,R,.,.,R
R,.,.,.,R,R,R,.,.,.,.,.,.,.,R,R,R,.,.,R
R,.,.,.,.,.,.,.,.,.,.,.,.,.,.,.,.,.,.,R
R,R,R,R,R,R,R,R,R,R,R,R,R,R,R,R,R,R,R,R
