R,R,R,R,R,R,R,R,R,R,R,R,R,R,R,R,R,R,R,R
R,.,.,.,.,.,.,.,.,.,.,.,.,.,.,.,.,.,.,R
R,.,.,R,R,.,.,.,.,.,.,.,.,.,.,.,.,.,.,R
R,.,.,R,.,.,.,.,R,R,R,.,.,.,.,.,R,R,.,R
R,.,.,.,.,.,.,.,.,.,.,.,.,.,.,.,.,.,.,.
R,.,.,.,.,.,G,.,.,.,.,.,.,.,.,.,.,.,.,.
R,.,.,.,.,.,G,.,.,.,.,.,.,.,.,.,.,.,.,.
R,.,.,.,.,.,.,.,R,R,R,.,.,T,T,.,.,.,.,R
R,.,.,.,.,.,.,.,.,.,.,.,.,T,.,.,.,.,.,R
R,.,.,.,.,.,.,.,.,.,.,.,.,.,.,.,.,.,.,R
R,R,R,R,R,R,R,R,R,.,.,.,R,R,R,R,R,R,R,R
