R,R,R,R,R,R,R,R,R,.,.,.,R,R,R,R,R,R,R,R
R,.,.,.,.,.,.,.,.,.,.,.,.,.,.,.,.,.,.,R
R,.,.,.,R,R,R,.,.,.,.,.,.,.,.,.,.,.,.,R
R,.,.,.,R,.,.,.,.,.,.,.,.,R,R,R,.,.,.,R
.,.,.,.,.,.,.,.,.,.,.,.,.,R,.,.,.,.,.,R
.,.,.,.,.,.,.,.,.,.,.,.,.,.,.,.,.,.,.,R
.,.,.,.,.,.,.,R,R,R,R,R,.,.,.,.,.,.,.,R
R,.,.,.,.,.,.,.,.,.,.,.,.,.,.,.,T,.,.,R
R,.,.,G,G,.,.,.,.,.,.,.,.,.,.,.,T,.,.,R
R,.,.,.,.,.,.,.,.,.,.,.,.,.,.,.,.,.,.,R
R,R,R,R,R,R,R,R,R,R,R,R,R,R,R,R,R,R,R,R
