R,R,R,R,R,R,R,R,R,R,R,R,R,R,R,R,R,R,R,R
R,.,.,.,.,.,.,.,.,.,.,.,.,.,.,.,.,.,.,R
R,.,.,.,T,T,.,.,.,.,.,.,.,T,T,.,.,.,.,R
R,.,.,.,T,T,.,.,.,.,.,.,.,T,T,.,.,.,.,R
R,.,.,.,.,.,.,.,.,.,.,.,.,.,.,.,.,.,.,.
R,.,.,.,.,.,.,.,.,R,R,.,.,.,.,.,.,.,.,.
R,.,.,.,.,.,.,.,.,.,.,.,.,.,.,.,.,.,.,.
R,.,.,.,.,.,R,R,.,.,.,.,R,R,.,.,.,.,.,R
R,.,.,.,.,.,.,.,.,G,G,.,.,.,.,.,.,.,.,R
R,.,.,.,.,.,.,.,.,.,.,.,.,.,.,.,.,.,.,R
R,R,R,R,R,R,R,R,R,.,.,.,R,R,R,R,R,R,R,R
