R,R,R,R,R,R,R,R,R,R,R,R,R,R,R,R,R,R,R,R
R,.,.,.,.,.,.,.,.,.,.,.,.,.,.,.,.,.,.,R
R,.,.,R,.,R,.,.,.,.,.,.,.,.,R,R,.,.,.,R
R,.,.,.,R,.,.,.,.,.,.,.,.,.,.,.,R,.,.,R
R,.,.,.,.,.,.,.,.,.,.,.,.,.,.,.,.,.,.,.
R,.,.,.,.,.,.,.,R,R,R,R,.,.,.,.,.,.,.,.
R,.,.,.,.,.,.,.,.,.,.,.,.,.,.,.,.,.,.,.
R,.,.,.,R,R,.,.,.,.,.,G,.,.,.,.,T,.,.,R
R,.,.,.,.,.,R,.,.,.,.,G,G,.,.,.,T,.,.,R
R,.,.,.,.,.,.,.,.,.,.,.,.,.,.,.,.,.,.,R
R,R,R,R,R,R,R,R,R,.,.,.,R,R,R,R,R,R,R,R
