R,R,R,R,R,R,R,R,R,.,.,.,R,R,R,R,R,R,R,R
R,.,.,.,.,.,.,.,.,.,.,.,.,.,.,.,.,.,.,R
R,.,.,.,R,R,.,.,.,.,.,.,.,.,.,R,R,.,.,R
R,.,.,.,.,.,.,.,.,.,.,.,.,.,.,.,.,.,.,R
.,.,.,.,.,.,.,.,.,R,R,.,.,.,.,.,.,.,.,R
.,.,.,G,.,.,.,.,.,.,.,.,.,.,.,.,.,G,.,R
.,.,.,.,.,.,.,.,.,R,R,.,.,.,.,.,.,.,.,R
R,.,.,.,.,.,.,.,.,.,.,.,.,.,.,.,.,.,.,R
R,.,.,.,R,R,.,.,.,.,.,.,.,.,.,R,R,.,.,R
R,.,.,.,.,.,.,.,.,.,.,.,.,.,.,.,.,.,.,R
R,R,R,R,R,R,R,R,R,R,R,R,R,R,R,R,R,R,R,R
