R,R,R,R,R,R,R,R,R,.,.,.,R,R,R,R,R,R,R,R
R,.,.,.,.,.,.,.,.,.,.,.,.,.,.,.,.,.,.,R
R,.,.,.,.,.,.,.,.,.,.,.,.,.,.,.,T,.,.,R
R,.,.,.,.,R,R,R,.,.,.,.,.,.,.,.,T,.,.,R
.,.,.,.,.,R,.,.,.,.,.,.,.,.,.,.,.,.,.,R
.,.,.,.,.,.,.,.,.,.,.,.,.,.,.,.,.,.,.,R
.,.,.,.,.,.,.,.,.,.,.,.,R,R,R,.,.,.,.,R
R,.,.,.,.,.,.,.,.,.,.,.,.,.,R,.,.,.,.,R
R,.,.,T,.,.,.,.,.,G,G,.,.,.,.,.,.,.,.,R
R,.,.,.,.,.,.,.,.,.,.,.,.,.,.,.,.,.,.,R
R,R,R,R,R,R,R,R,R,R,R,R,R,R,R,R,R,R,R,R
