#,#,#,#,#,#,#,#,#,#,#,#,#,#,#,#,#,#,#,#
#,.,.,.,#,.,.,.,.,.,#,.,.,.,.,.,#,.,.,#
#,.,.,.,#,.,.,#,.,.,#,.,.,#,.,.,#,.,.,#
#,.,.,.,#,.,.,#,.,.,#,.,.,#,.,.,#,.,.,#
.,.,.,.,#,.,.,#,.,.,#,.,.,#,.,.,#,.,.,.
.,.,.,.,#,.,.,#,.,.,#,.,.,#,.,.,#,.,.,.
.,.,.,.,#,.,.,#,.,.,#,.,.,#,.,.,#,.,.,.
#,.,.,.,#,.,.,#,.,.,#,.,.,#,.,.,#,.,.,#
#,.,.,.,#,.,.,#,.,.,#,.,.,#,.,.,#,.,.,#
#,.,.,.,.,.,.,#,.,.,.,.,.,#,.,.,.,.,.,#
#,#,#,#,#,#,#,#,#,#,#,#,#,#,#,#,#,#,#,#
