T,T,T,T,T,T,T,T,T,T,T,T,T,T,T,T,T,T,T,T
T,.,.,.,.,.,.,.,.,.,.,.,.,.,.,.,.,.,.,T
T,.,.,.,T,T,.,.,.,.,.,.,.,T,T,T,.,.,.,T
T,.,.,.,T,T,.,.,.,.,.,.,.,.,.,.,.,.,.,T
T,.,.,.,.,.,.,.,.,.,.,.,.,.,.,.,.,.,.,.
T,.,.,.,.,.,.,.,.,.,.,.,.,.,.,.,.,.,.,.
T,.,.,.,.,.,.,.,.,.,.,.,.,.,.,.,.,.,.,.
T,.,.,.,.,.,T,T,.,.,.,.,.,.,.,.,.,.,.,T
T,.,.,.,.,~,~,~,~,.,.,.,.,R,R,.,.,.,.,T
T,.,.,.,.,~,~,~,~,.,.,.,.,.,.,.,.,.,.,T
T,T,T,T,T,T,T,T,T,T,T,T,T,T,T,T,T,T,T,T
