#,#,#,#,#,#,#,#,#,#,#,#,#,#,#,#,#,#,#,#
#,.,.,.,.,.,.,.,.,.,.,.,.,.,.,.,.,.,.,#
#,.,.,T,.,.,.,.,.,.,.,.,.,.,.,.,T,.,.,#
#,.,.,.,.,.,.,.,.,.,.,.,.,.,.,.,.,.,.,#
#,.,.,.,.,.,.,.,.,.,.,.,.,.,.,.,.,.,.,.
#,.,.,.,.,.,.,.,.,.,.,.,.,.,.,.,.,.,.,.
#,.,.,.,.,.,.,.,.,.,.,.,.,.,.,.,.,.,.,.
#,.,.,.,.,R,.,.,.,.,.,.,.,.,R,.,.,.,.,#
#,.,.,.,.,.,.,.,.,R,.,.,.,.,.,.,.,.,.,#
#,.,.,.,.,.,.,.,.,.,.,.,.,.,.,.,.,.,.,#
#,#,#,#,#,#,#,#,#,#,#,#,#,#,#,#,#,#,#,#
