#,#,#,#,#,#,#,#,#,#,#,#,#,#,#,#,#,#,#,#
#,.,.,.,.,.,.,.,.,.,.,.,.,.,.,.,.,.,.,#
#,.,T,.,.,.,.,.,.,.,.,.,.,.,.,.,.,T,.,#
#,.,.,.,.,.,.,.,.,.,.,.,.,.,.,.,.,.,.,#
#,.,.,.,.,#,#,#,.,.,.,.,#,#,#,.,.,.,.,#
#,.,.,.,.,.,.,.,.,.,.,.,.,.,.,.,.,.,.,#
#,.,.,.,.,.,.,.,.,.,.,.,.,.,.,.,.,.,.,#
#,.,.,.,.,.,.,.,.,.,.,.,.,.,.,.,.,.,.,#
#,.,.,.,R,.,.,.,.,.,.,.,.,.,.,R,.,.,.,#
#,.,.,.,.,.,.,.,.,.,.,.,.,.,.,.,.,.,.,#
#,#,#,#,#,#,#,#,#,.,.,.,#,#,#,#,#,#,#,#
